OOOOOOOOOOOOOOOOOOOOOOTOO/\TTIITTTOOTTTI
OOOOOOOOOTT\T/\/00\TT/0\/0000\/000\/00TO
OOOOOOOOO/0000000000000000000000000000\T
OOOOTTOOOT00WWWWWWWWWWWWWWWWWWWW0000000T
OOT/00\TT000WDDDDDDDDDDDDDDDDDDW0000000T
TT0000000000WDDDDDDS||||||_||||||||||0/T
WWWWWWWWWWWWWDDDDDDS|--Y-----|DDDDDD|0\T
XDDDfDDDDDDDDDDDDDDS|--Y-----|DDDDDD|00T
XDDDDDDDDDDDDDDDDDDS|--Y-----_fDDDDD|/\T
XDDDDDDDDSSSSSSSSSSSYYYYYYYYYYYYYYY~Y00T
IIFFFFFFFIIIIIIIIIIIqII][=d===B=====Y111
MBBBBBBBBBBB===][kzNNzk[]d====B=====ISD1
I==========B=e=[]kzzzzkKd=====B=====ISD1
I==========B=====szzzzk][c====Be====~SD1
I========][IIIIIIIIIIII[]====IMIIIIIISD1
I========[]I}{DDDDDDfDIII^^IIIICDfSSSSD1
IBBBBBBBBBBI{}DDDDDDDDDDDDDDDDDDDDDDDDD1
I========e=IDDDDDDDDDDDDDDDDDDDDDDDDDDD1
I==========IDDDSSSSSSSSSSSSSSSSSSSSSSSD1
IIIIIIIIIIIIDDDSIIIIIIIIIIIIIIIIIIIIIIII
1DDDDDDDDDDDDDDSI=====B=====c======B===I
1DDfDDDDDDDDDDDSI=====B==d=========B===I
1DDDDDDDDDDDDDDSIBBBBBBBBBBBBBBBBBBIBBBI
IIIIIIIIIIIIISDSI=====B=======B===dI===I
IDIDDDDDDDDDISDSI=====B=======Be=dcI===I
IDIDDDDDDDDD^DDSIBBBBBBIIIIIIIIIIIII===I
IDIDDDDDDDDD^DDSI======I][d===B========I
IDIDDDDDDDDDISDSI=====eI[]====B========I
IDIDDDDDDDDDISDSIE====dI======B========I
IDIYYYYYYYYYYSDSY#YQYYYYBBBBBBBBBBBB===I
IDIDDDDDDDDDYSDSY?=====Y===========B=t=Q
IDIDDDDDDDDDYSDSY======YIMI==I=====B=yeI
IDIDDDDDDDDDYSDSYYYYYYYY^^IFFIIIIIIIIIII
IDIDDDDDDDDDYSDSSSSSSSSSSSSDDSSSSSSSSSS1
IDIDDDDDDDDDYSDDDDDDDDDDDDDDDDDDDDD}{DS1
IDIDDDDDDDDDYSDDDDDDDDDDDDDDDDDDDDD{}DS1
IYYYYYYYYYYYYSCDDDDDDDDDDDDDDDDDDCDDDDS1
1DDDDDDDDDDDDSDDDDDDDDDDDDDDDDDDDDDDDDS1
1DDDDDDDDDDDDSSS4SSSSSSSSSSSSSSSSSSSSSS1
11111111111111111XXXXm111111111111111111